BBBBWBBBB
BBWWEWWBB
WWEEEEEWW
WEEEEEEEW
WEEESEEEW
WEEEEEEEW
WEEEEEEEW
BWWEEEWWB
BBBWWWBBB
